dat;year;month;woj;teryt;k64;k65;m64;m65;total
2015-09-01;2015;09;dolnośląskie;02;208;816;463;697;2184
2015-09-01;2015;09;kujawsko-pomorskie;04;126;520;286;492;1424
2015-09-01;2015;09;lubelskie;06;109;597;284;489;1479
2015-09-01;2015;09;lubuskie;08;56;261;148;208;673
2015-09-01;2015;09;łódzkie;10;162;879;395;626;2062
2015-09-01;2015;09;małopolskie;12;172;926;419;777;2294
2015-09-01;2015;09;mazowieckie;14;357;1613;755;1279;4004
2015-09-01;2015;09;opolskie;16;59;310;153;236;758
2015-09-01;2015;09;podkarpackie;18;108;580;242;481;1411
2015-09-01;2015;09;podlaskie;20;63;369;172;331;935
2015-09-01;2015;09;pomorskie;22;143;624;297;512;1576
2015-09-01;2015;09;śląskie;24;373;1322;691;1160;3546
2015-09-01;2015;09;świętokrzyskie;26;60;355;170;353;938
2015-09-01;2015;09;warmińsko-mazurskie;28;72;379;211;301;963
2015-09-01;2015;09;wielkopolskie;30;188;893;465;724;2270
2015-09-01;2015;09;zachodniopomorskie;32;127;477;249;389;1242
2015-10-01;2015;10;dolnośląskie;02;203;1001;534;745;2483
2015-10-01;2015;10;kujawsko-pomorskie;04;149;598;322;530;1599
2015-10-01;2015;10;lubelskie;06;93;705;332;625;1755
2015-10-01;2015;10;lubuskie;08;63;293;152;273;781
2015-10-01;2015;10;łódzkie;10;187;941;453;757;2338
2015-10-01;2015;10;małopolskie;12;221;1030;390;903;2544
2015-10-01;2015;10;mazowieckie;14;372;1852;842;1515;4581
2015-10-01;2015;10;opolskie;16;59;347;142;274;822
2015-10-01;2015;10;podkarpackie;18;88;640;242;520;1490
2015-10-01;2015;10;podlaskie;20;61;414;182;375;1032
2015-10-01;2015;10;pomorskie;22;144;662;327;542;1675
2015-10-01;2015;10;śląskie;24;350;1562;779;1260;3951
2015-10-01;2015;10;świętokrzyskie;26;75;467;227;383;1152
2015-10-01;2015;10;warmińsko-mazurskie;28;81;394;238;384;1097
2015-10-01;2015;10;wielkopolskie;30;209;1007;483;855;2554
2015-10-01;2015;10;zachodniopomorskie;32;110;521;284;456;1371
2015-11-01;2015;11;dolnośląskie;02;212;927;474;772;2385
2015-11-01;2015;11;kujawsko-pomorskie;04;144;599;321;516;1580
2015-11-01;2015;11;lubelskie;06;115;752;293;598;1758
2015-11-01;2015;11;lubuskie;08;73;309;178;245;805
2015-11-01;2015;11;łódzkie;10;218;952;504;763;2437
2015-11-01;2015;11;małopolskie;12;151;1020;404;803;2378
2015-11-01;2015;11;mazowieckie;14;310;1853;859;1511;4533
2015-11-01;2015;11;opolskie;16;64;344;127;293;828
2015-11-01;2015;11;podkarpackie;18;110;660;267;513;1550
2015-11-01;2015;11;podlaskie;20;54;386;160;337;937
2015-11-01;2015;11;pomorskie;22;136;700;342;555;1733
2015-11-01;2015;11;śląskie;24;381;1525;784;1319;4009
2015-11-01;2015;11;świętokrzyskie;26;54;433;221;411;1119
2015-11-01;2015;11;warmińsko-mazurskie;28;94;417;231;324;1066
2015-11-01;2015;11;wielkopolskie;30;221;1128;505;843;2697
2015-11-01;2015;11;zachodniopomorskie;32;141;522;290;414;1367
2015-12-01;2015;12;dolnośląskie;02;206;1020;501;834;2561
2015-12-01;2015;12;kujawsko-pomorskie;04;146;690;305;587;1728
2015-12-01;2015;12;lubelskie;06;111;779;348;648;1886
2015-12-01;2015;12;lubuskie;08;85;317;176;241;819
2015-12-01;2015;12;łódzkie;10;194;1022;522;779;2517
2015-12-01;2015;12;małopolskie;12;176;1055;468;879;2578
2015-12-01;2015;12;mazowieckie;14;352;1834;854;1507;4547
2015-12-01;2015;12;opolskie;16;56;349;164;298;867
2015-12-01;2015;12;podkarpackie;18;98;596;276;505;1475
2015-12-01;2015;12;podlaskie;20;66;373;171;347;957
2015-12-01;2015;12;pomorskie;22;171;699;333;580;1783
2015-12-01;2015;12;śląskie;24;398;1579;796;1329;4102
2015-12-01;2015;12;świętokrzyskie;26;72;439;209;422;1142
2015-12-01;2015;12;warmińsko-mazurskie;28;90;408;258;362;1118
2015-12-01;2015;12;wielkopolskie;30;227;1029;503;883;2642
2015-12-01;2015;12;zachodniopomorskie;32;132;541;292;460;1425
2016-01-01;2016;01;dolnośląskie;02;244;1072;533;845;2694
2016-01-01;2016;01;kujawsko-pomorskie;04;151;689;325;610;1775
2016-01-01;2016;01;lubelskie;06;133;861;347;686;2027
2016-01-01;2016;01;lubuskie;08;65;338;181;291;875
2016-01-01;2016;01;łódzkie;10;222;1066;537;845;2670
2016-01-01;2016;01;małopolskie;12;189;1182;410;1004;2785
2016-01-01;2016;01;mazowieckie;14;343;2117;857;1672;4989
2016-01-01;2016;01;opolskie;16;64;388;158;300;910
2016-01-01;2016;01;podkarpackie;18;108;728;261;595;1692
2016-01-01;2016;01;podlaskie;20;73;403;173;371;1020
2016-01-01;2016;01;pomorskie;22;162;760;338;643;1903
2016-01-01;2016;01;śląskie;24;398;1775;859;1409;4441
2016-01-01;2016;01;świętokrzyskie;26;87;501;192;387;1167
2016-01-01;2016;01;warmińsko-mazurskie;28;106;479;266;385;1236
2016-01-01;2016;01;wielkopolskie;30;217;1136;557;948;2858
2016-01-01;2016;01;zachodniopomorskie;32;136;578;313;501;1528
2016-02-01;2016;02;dolnośląskie;02;189;1002;533;832;2556
2016-02-01;2016;02;kujawsko-pomorskie;04;138;606;302;559;1605
2016-02-01;2016;02;lubelskie;06;101;778;339;621;1839
2016-02-01;2016;02;lubuskie;08;62;306;186;268;822
2016-02-01;2016;02;łódzkie;10;209;1028;444;826;2507
2016-02-01;2016;02;małopolskie;12;183;1049;377;829;2438
2016-02-01;2016;02;mazowieckie;14;354;1955;805;1599;4713
2016-02-01;2016;02;opolskie;16;58;351;137;297;843
2016-02-01;2016;02;podkarpackie;18;89;722;249;545;1605
2016-02-01;2016;02;podlaskie;20;69;403;168;351;991
2016-02-01;2016;02;pomorskie;22;125;726;319;597;1767
2016-02-01;2016;02;śląskie;24;392;1568;714;1303;3977
2016-02-01;2016;02;świętokrzyskie;26;84;436;176;375;1071
2016-02-01;2016;02;warmińsko-mazurskie;28;103;404;206;376;1089
2016-02-01;2016;02;wielkopolskie;30;218;1084;493;873;2668
2016-02-01;2016;02;zachodniopomorskie;32;116;594;307;458;1475
2016-03-01;2016;03;dolnośląskie;02;229;1044;486;830;2589
2016-03-01;2016;03;kujawsko-pomorskie;04;154;784;375;618;1931
2016-03-01;2016;03;lubelskie;06;119;803;320;632;1874
2016-03-01;2016;03;lubuskie;08;74;326;224;294;918
2016-03-01;2016;03;łódzkie;10;211;1093;463;811;2578
2016-03-01;2016;03;małopolskie;12;162;1088;455;956;2661
2016-03-01;2016;03;mazowieckie;14;347;1948;905;1650;4850
2016-03-01;2016;03;opolskie;16;60;344;151;292;847
2016-03-01;2016;03;podkarpackie;18;79;678;246;601;1604
2016-03-01;2016;03;podlaskie;20;56;427;177;365;1025
2016-03-01;2016;03;pomorskie;22;163;722;327;614;1826
2016-03-01;2016;03;śląskie;24;404;1717;778;1430;4329
2016-03-01;2016;03;świętokrzyskie;26;70;510;213;422;1215
2016-03-01;2016;03;warmińsko-mazurskie;28;85;456;248;425;1214
2016-03-01;2016;03;wielkopolskie;30;268;1117;483;934;2802
2016-03-01;2016;03;zachodniopomorskie;32;140;574;334;493;1541
2016-04-01;2016;04;dolnośląskie;02;202;958;491;763;2414
2016-04-01;2016;04;kujawsko-pomorskie;04;138;665;322;538;1663
2016-04-01;2016;04;lubelskie;06;133;656;335;601;1725
2016-04-01;2016;04;lubuskie;08;68;332;158;255;813
2016-04-01;2016;04;łódzkie;10;193;1014;496;743;2446
2016-04-01;2016;04;małopolskie;12;158;1067;404;867;2496
2016-04-01;2016;04;mazowieckie;14;269;1785;775;1458;4287
2016-04-01;2016;04;opolskie;16;59;341;139;265;804
2016-04-01;2016;04;podkarpackie;18;95;642;259;545;1541
2016-04-01;2016;04;podlaskie;20;64;392;142;348;946
2016-04-01;2016;04;pomorskie;22;154;640;338;598;1730
2016-04-01;2016;04;śląskie;24;342;1535;748;1312;3937
2016-04-01;2016;04;świętokrzyskie;26;67;465;191;374;1097
2016-04-01;2016;04;warmińsko-mazurskie;28;98;401;236;362;1097
2016-04-01;2016;04;wielkopolskie;30;220;1027;490;882;2619
2016-04-01;2016;04;zachodniopomorskie;32;117;498;252;457;1324
2016-05-01;2016;05;dolnośląskie;02;204;956;466;827;2453
2016-05-01;2016;05;kujawsko-pomorskie;04;158;662;319;580;1719
2016-05-01;2016;05;lubelskie;06;111;722;327;645;1805
2016-05-01;2016;05;lubuskie;08;65;315;176;263;819
2016-05-01;2016;05;łódzkie;10;196;954;449;776;2375
2016-05-01;2016;05;małopolskie;12;165;1028;451;861;2505
2016-05-01;2016;05;mazowieckie;14;334;1847;814;1464;4459
2016-05-01;2016;05;opolskie;16;54;332;148;270;804
2016-05-01;2016;05;podkarpackie;18;103;623;267;531;1524
2016-05-01;2016;05;podlaskie;20;66;381;179;336;962
2016-05-01;2016;05;pomorskie;22;143;686;324;586;1739
2016-05-01;2016;05;śląskie;24;325;1531;796;1299;3951
2016-05-01;2016;05;świętokrzyskie;26;78;461;189;423;1151
2016-05-01;2016;05;warmińsko-mazurskie;28;98;421;228;405;1152
2016-05-01;2016;05;wielkopolskie;30;239;1041;495;872;2647
2016-05-01;2016;05;zachodniopomorskie;32;121;527;306;455;1409
2016-06-01;2016;06;dolnośląskie;02;168;871;469;715;2223
2016-06-01;2016;06;kujawsko-pomorskie;04;113;602;281;486;1482
2016-06-01;2016;06;lubelskie;06;101;678;307;607;1693
2016-06-01;2016;06;lubuskie;08;70;250;149;266;735
2016-06-01;2016;06;łódzkie;10;167;950;454;686;2257
2016-06-01;2016;06;małopolskie;12;143;989;434;831;2397
2016-06-01;2016;06;mazowieckie;14;312;1694;789;1383;4178
2016-06-01;2016;06;opolskie;16;51;304;135;263;753
2016-06-01;2016;06;podkarpackie;18;70;632;227;530;1459
2016-06-01;2016;06;podlaskie;20;54;394;164;311;923
2016-06-01;2016;06;pomorskie;22;126;627;264;579;1596
2016-06-01;2016;06;śląskie;24;320;1428;733;1244;3725
2016-06-01;2016;06;świętokrzyskie;26;74;450;199;352;1075
2016-06-01;2016;06;warmińsko-mazurskie;28;102;384;233;344;1063
2016-06-01;2016;06;wielkopolskie;30;217;998;460;810;2485
2016-06-01;2016;06;zachodniopomorskie;32;114;455;282;403;1254
2016-07-01;2016;07;dolnośląskie;02;217;945;439;737;2338
2016-07-01;2016;07;kujawsko-pomorskie;04;160;574;319;501;1554
2016-07-01;2016;07;lubelskie;06;103;705;291;583;1682
2016-07-01;2016;07;lubuskie;08;75;267;184;259;785
2016-07-01;2016;07;łódzkie;10;198;884;439;712;2233
2016-07-01;2016;07;małopolskie;12;163;975;417;842;2397
2016-07-01;2016;07;mazowieckie;14;349;1739;821;1391;4300
2016-07-01;2016;07;opolskie;16;55;302;118;260;735
2016-07-01;2016;07;podkarpackie;18;99;587;232;490;1408
2016-07-01;2016;07;podlaskie;20;65;385;212;320;982
2016-07-01;2016;07;pomorskie;22;133;596;350;559;1638
2016-07-01;2016;07;śląskie;24;314;1455;710;1250;3729
2016-07-01;2016;07;świętokrzyskie;26;78;473;198;353;1102
2016-07-01;2016;07;warmińsko-mazurskie;28;112;364;245;370;1091
2016-07-01;2016;07;wielkopolskie;30;168;999;481;850;2498
2016-07-01;2016;07;zachodniopomorskie;32;114;491;251;408;1264
2016-08-01;2016;08;dolnośląskie;02;215;976;469;780;2440
2016-08-01;2016;08;kujawsko-pomorskie;04;143;606;277;512;1538
2016-08-01;2016;08;lubelskie;06;112;647;300;557;1616
2016-08-01;2016;08;lubuskie;08;81;299;186;232;798
2016-08-01;2016;08;łódzkie;10;173;925;441;722;2261
2016-08-01;2016;08;małopolskie;12;135;1008;436;766;2345
2016-08-01;2016;08;mazowieckie;14;350;1724;775;1398;4247
2016-08-01;2016;08;opolskie;16;53;322;135;237;747
2016-08-01;2016;08;podkarpackie;18;96;593;249;532;1470
2016-08-01;2016;08;podlaskie;20;64;382;192;311;949
2016-08-01;2016;08;pomorskie;22;139;642;332;575;1688
2016-08-01;2016;08;śląskie;24;352;1468;709;1204;3733
2016-08-01;2016;08;świętokrzyskie;26;69;403;203;350;1025
2016-08-01;2016;08;warmińsko-mazurskie;28;87;418;229;366;1100
2016-08-01;2016;08;wielkopolskie;30;198;962;493;819;2472
2016-08-01;2016;08;zachodniopomorskie;32;133;480;278;468;1359
2016-09-01;2016;09;dolnośląskie;02;199;938;455;736;2328
2016-09-01;2016;09;kujawsko-pomorskie;04;140;568;328;510;1546
2016-09-01;2016;09;lubelskie;06;113;666;303;562;1644
2016-09-01;2016;09;lubuskie;08;60;259;153;251;723
2016-09-01;2016;09;łódzkie;10;192;917;433;727;2269
2016-09-01;2016;09;małopolskie;12;151;949;439;801;2340
2016-09-01;2016;09;mazowieckie;14;324;1723;800;1418;4265
2016-09-01;2016;09;opolskie;16;42;317;139;271;769
2016-09-01;2016;09;podkarpackie;18;105;563;249;471;1388
2016-09-01;2016;09;podlaskie;20;53;385;159;343;940
2016-09-01;2016;09;pomorskie;22;130;630;294;565;1619
2016-09-01;2016;09;śląskie;24;328;1450;736;1248;3762
2016-09-01;2016;09;świętokrzyskie;26;72;433;192;353;1050
2016-09-01;2016;09;warmińsko-mazurskie;28;75;394;225;363;1057
2016-09-01;2016;09;wielkopolskie;30;230;956;449;818;2453
2016-09-01;2016;09;zachodniopomorskie;32;109;438;265;429;1241
2016-10-01;2016;10;dolnośląskie;02;210;992;494;866;2562
2016-10-01;2016;10;kujawsko-pomorskie;04;136;659;323;565;1683
2016-10-01;2016;10;lubelskie;06;110;798;347;667;1922
2016-10-01;2016;10;lubuskie;08;72;309;158;292;831
2016-10-01;2016;10;łódzkie;10;169;975;482;788;2414
2016-10-01;2016;10;małopolskie;12;164;1056;436;944;2600
2016-10-01;2016;10;mazowieckie;14;330;1892;803;1576;4601
2016-10-01;2016;10;opolskie;16;56;366;140;295;857
2016-10-01;2016;10;podkarpackie;18;101;671;294;530;1596
2016-10-01;2016;10;podlaskie;20;66;428;167;347;1008
2016-10-01;2016;10;pomorskie;22;160;683;345;619;1807
2016-10-01;2016;10;śląskie;24;337;1600;788;1338;4063
2016-10-01;2016;10;świętokrzyskie;26;73;472;226;412;1183
2016-10-01;2016;10;warmińsko-mazurskie;28;102;461;243;393;1199
2016-10-01;2016;10;wielkopolskie;30;202;1068;512;933;2715
2016-10-01;2016;10;zachodniopomorskie;32;113;538;314;492;1457
2016-11-01;2016;11;dolnośląskie;02;227;1013;460;805;2505
2016-11-01;2016;11;kujawsko-pomorskie;04;143;621;331;567;1662
2016-11-01;2016;11;lubelskie;06;104;700;322;628;1754
2016-11-01;2016;11;lubuskie;08;72;277;181;269;799
2016-11-01;2016;11;łódzkie;10;193;958;465;808;2424
2016-11-01;2016;11;małopolskie;12;167;1064;414;887;2532
2016-11-01;2016;11;mazowieckie;14;297;1806;795;1484;4382
2016-11-01;2016;11;opolskie;16;80;344;133;298;855
2016-11-01;2016;11;podkarpackie;18;80;623;257;519;1479
2016-11-01;2016;11;podlaskie;20;64;427;157;339;987
2016-11-01;2016;11;pomorskie;22;157;713;306;580;1756
2016-11-01;2016;11;śląskie;24;343;1644;747;1329;4063
2016-11-01;2016;11;świętokrzyskie;26;65;441;202;417;1125
2016-11-01;2016;11;warmińsko-mazurskie;28;102;431;229;368;1130
2016-11-01;2016;11;wielkopolskie;30;207;1055;478;913;2653
2016-11-01;2016;11;zachodniopomorskie;32;117;537;275;477;1406
2016-12-01;2016;12;dolnośląskie;02;215;1058;484;829;2586
2016-12-01;2016;12;kujawsko-pomorskie;04;141;678;309;587;1715
2016-12-01;2016;12;lubelskie;06;117;856;338;699;2010
2016-12-01;2016;12;lubuskie;08;66;353;186;281;886
2016-12-01;2016;12;łódzkie;10;215;1120;484;828;2647
2016-12-01;2016;12;małopolskie;12;163;1150;434;1000;2747
2016-12-01;2016;12;mazowieckie;14;364;2101;928;1754;5147
2016-12-01;2016;12;opolskie;16;86;375;178;299;938
2016-12-01;2016;12;podkarpackie;18;100;687;265;583;1635
2016-12-01;2016;12;podlaskie;20;58;457;170;386;1071
2016-12-01;2016;12;pomorskie;22;139;767;324;662;1892
2016-12-01;2016;12;śląskie;24;379;1763;841;1480;4463
2016-12-01;2016;12;świętokrzyskie;26;95;563;236;487;1381
2016-12-01;2016;12;warmińsko-mazurskie;28;97;442;255;367;1161
2016-12-01;2016;12;wielkopolskie;30;223;1184;501;952;2860
2016-12-01;2016;12;zachodniopomorskie;32;121;597;296;471;1485
2017-01-01;2017;01;dolnośląskie;02;269;1522;548;1118;3457
2017-01-01;2017;01;kujawsko-pomorskie;04;170;847;339;644;2000
2017-01-01;2017;01;lubelskie;06;132;1157;384;919;2592
2017-01-01;2017;01;lubuskie;08;72;432;214;318;1036
2017-01-01;2017;01;łódzkie;10;237;1594;548;1117;3496
2017-01-01;2017;01;małopolskie;12;203;1619;514;1330;3666
2017-01-01;2017;01;mazowieckie;14;407;2858;959;2161;6385
2017-01-01;2017;01;opolskie;16;83;605;183;464;1335
2017-01-01;2017;01;podkarpackie;18;97;1011;292;793;2193
2017-01-01;2017;01;podlaskie;20;70;572;211;468;1321
2017-01-01;2017;01;pomorskie;22;171;884;344;721;2120
2017-01-01;2017;01;śląskie;24;417;2425;915;2027;5784
2017-01-01;2017;01;świętokrzyskie;26;89;757;215;533;1594
2017-01-01;2017;01;warmińsko-mazurskie;28;121;612;214;508;1455
2017-01-01;2017;01;wielkopolskie;30;213;1393;559;1125;3290
2017-01-01;2017;01;zachodniopomorskie;32;141;658;267;547;1613
2017-02-01;2017;02;dolnośląskie;02;225;1305;458;987;2975
2017-02-01;2017;02;kujawsko-pomorskie;04;169;908;291;690;2058
2017-02-01;2017;02;lubelskie;06;105;868;311;669;1953
2017-02-01;2017;02;lubuskie;08;68;435;153;293;949
2017-02-01;2017;02;łódzkie;10;196;1211;434;916;2757
2017-02-01;2017;02;małopolskie;12;148;1317;424;981;2870
2017-02-01;2017;02;mazowieckie;14;318;2322;728;1776;5144
2017-02-01;2017;02;opolskie;16;69;471;173;372;1085
2017-02-01;2017;02;podkarpackie;18;88;777;232;562;1659
2017-02-01;2017;02;podlaskie;20;61;530;170;438;1199
2017-02-01;2017;02;pomorskie;22;143;839;330;709;2021
2017-02-01;2017;02;śląskie;24;387;1973;725;1611;4696
2017-02-01;2017;02;świętokrzyskie;26;59;560;194;444;1257
2017-02-01;2017;02;warmińsko-mazurskie;28;97;582;238;445;1362
2017-02-01;2017;02;wielkopolskie;30;229;1403;456;1128;3216
2017-02-01;2017;02;zachodniopomorskie;32;113;691;272;559;1635
2017-03-01;2017;03;dolnośląskie;02;208;1042;463;846;2559
2017-03-01;2017;03;kujawsko-pomorskie;04;137;762;294;586;1779
2017-03-01;2017;03;lubelskie;06;97;884;317;676;1974
2017-03-01;2017;03;lubuskie;08;71;321;156;285;833
2017-03-01;2017;03;łódzkie;10;216;1087;415;889;2607
2017-03-01;2017;03;małopolskie;12;176;1152;409;954;2691
2017-03-01;2017;03;mazowieckie;14;314;2049;812;1656;4831
2017-03-01;2017;03;opolskie;16;68;382;141;298;889
2017-03-01;2017;03;podkarpackie;18;100;636;257;536;1529
2017-03-01;2017;03;podlaskie;20;66;468;188;364;1086
2017-03-01;2017;03;pomorskie;22;147;737;343;661;1888
2017-03-01;2017;03;śląskie;24;384;1721;755;1459;4319
2017-03-01;2017;03;świętokrzyskie;26;64;534;197;388;1183
2017-03-01;2017;03;warmińsko-mazurskie;28;106;468;238;403;1215
2017-03-01;2017;03;wielkopolskie;30;201;1139;480;948;2768
2017-03-01;2017;03;zachodniopomorskie;32;129;643;262;491;1525
2017-04-01;2017;04;dolnośląskie;02;206;952;445;776;2379
2017-04-01;2017;04;kujawsko-pomorskie;04;108;674;285;550;1617
2017-04-01;2017;04;lubelskie;06;100;750;296;589;1735
2017-04-01;2017;04;lubuskie;08;61;297;173;231;762
2017-04-01;2017;04;łódzkie;10;161;913;477;784;2335
2017-04-01;2017;04;małopolskie;12;169;1016;388;844;2417
2017-04-01;2017;04;mazowieckie;14;310;1881;778;1549;4518
2017-04-01;2017;04;opolskie;16;52;347;130;282;811
2017-04-01;2017;04;podkarpackie;18;78;628;273;527;1506
2017-04-01;2017;04;podlaskie;20;66;390;144;285;885
2017-04-01;2017;04;pomorskie;22;148;649;289;552;1638
2017-04-01;2017;04;śląskie;24;322;1543;697;1390;3952
2017-04-01;2017;04;świętokrzyskie;26;64;440;179;375;1058
2017-04-01;2017;04;warmińsko-mazurskie;28;88;406;187;339;1020
2017-04-01;2017;04;wielkopolskie;30;223;950;484;861;2518
2017-04-01;2017;04;zachodniopomorskie;32;125;516;267;476;1384
2017-05-01;2017;05;dolnośląskie;02;188;981;502;748;2419
2017-05-01;2017;05;kujawsko-pomorskie;04;159;653;298;573;1683
2017-05-01;2017;05;lubelskie;06;114;766;293;624;1797
2017-05-01;2017;05;lubuskie;08;81;285;170;257;793
2017-05-01;2017;05;łódzkie;10;179;960;449;772;2360
2017-05-01;2017;05;małopolskie;12;174;1030;370;886;2460
2017-05-01;2017;05;mazowieckie;14;307;1793;794;1517;4411
2017-05-01;2017;05;opolskie;16;65;322;140;268;795
2017-05-01;2017;05;podkarpackie;18;68;608;239;541;1456
2017-05-01;2017;05;podlaskie;20;50;417;181;316;964
2017-05-01;2017;05;pomorskie;22;136;651;311;567;1665
2017-05-01;2017;05;śląskie;24;325;1520;751;1291;3887
2017-05-01;2017;05;świętokrzyskie;26;61;437;197;367;1062
2017-05-01;2017;05;warmińsko-mazurskie;28;95;372;227;361;1055
2017-05-01;2017;05;wielkopolskie;30;205;981;445;926;2557
2017-05-01;2017;05;zachodniopomorskie;32;119;509;273;453;1354
2017-06-01;2017;06;dolnośląskie;02;197;863;468;720;2248
2017-06-01;2017;06;kujawsko-pomorskie;04;102;576;244;478;1400
2017-06-01;2017;06;lubelskie;06;102;738;266;560;1666
2017-06-01;2017;06;lubuskie;08;51;285;163;224;723
2017-06-01;2017;06;łódzkie;10;177;889;391;721;2178
2017-06-01;2017;06;małopolskie;12;160;945;401;784;2290
2017-06-01;2017;06;mazowieckie;14;308;1669;686;1355;4018
2017-06-01;2017;06;opolskie;16;53;317;137;273;780
2017-06-01;2017;06;podkarpackie;18;75;567;228;503;1373
2017-06-01;2017;06;podlaskie;20;55;365;163;309;892
2017-06-01;2017;06;pomorskie;22;134;628;270;548;1580
2017-06-01;2017;06;śląskie;24;302;1420;686;1251;3659
2017-06-01;2017;06;świętokrzyskie;26;65;437;199;347;1048
2017-06-01;2017;06;warmińsko-mazurskie;28;68;375;224;332;999
2017-06-01;2017;06;wielkopolskie;30;189;977;447;812;2425
2017-06-01;2017;06;zachodniopomorskie;32;96;530;238;442;1306
2017-07-01;2017;07;dolnośląskie;02;191;964;439;767;2361
2017-07-01;2017;07;kujawsko-pomorskie;04;169;639;311;537;1656
2017-07-01;2017;07;lubelskie;06;105;692;326;578;1701
2017-07-01;2017;07;lubuskie;08;75;289;164;250;778
2017-07-01;2017;07;łódzkie;10;197;913;425;756;2291
2017-07-01;2017;07;małopolskie;12;166;988;402;881;2437
2017-07-01;2017;07;mazowieckie;14;310;1742;763;1417;4232
2017-07-01;2017;07;opolskie;16;55;307;114;255;731
2017-07-01;2017;07;podkarpackie;18;79;607;254;495;1435
2017-07-01;2017;07;podlaskie;20;65;374;176;354;969
2017-07-01;2017;07;pomorskie;22;124;648;286;561;1619
2017-07-01;2017;07;śląskie;24;351;1512;702;1268;3833
2017-07-01;2017;07;świętokrzyskie;26;74;422;188;370;1054
2017-07-01;2017;07;warmińsko-mazurskie;28;72;436;246;344;1098
2017-07-01;2017;07;wielkopolskie;30;214;1002;454;859;2529
2017-07-01;2017;07;zachodniopomorskie;32;133;512;254;451;1350
2017-08-01;2017;08;dolnośląskie;02;217;986;499;820;2522
2017-08-01;2017;08;kujawsko-pomorskie;04;151;638;313;566;1668
2017-08-01;2017;08;lubelskie;06;121;681;310;598;1710
2017-08-01;2017;08;lubuskie;08;66;297;162;249;774
2017-08-01;2017;08;łódzkie;10;191;914;458;760;2323
2017-08-01;2017;08;małopolskie;12;183;1021;405;815;2424
2017-08-01;2017;08;mazowieckie;14;330;1776;782;1459;4347
2017-08-01;2017;08;opolskie;16;66;365;129;269;829
2017-08-01;2017;08;podkarpackie;18;96;584;245;483;1408
2017-08-01;2017;08;podlaskie;20;57;356;172;312;897
2017-08-01;2017;08;pomorskie;22;143;661;341;576;1721
2017-08-01;2017;08;śląskie;24;330;1471;721;1254;3776
2017-08-01;2017;08;świętokrzyskie;26;73;430;209;361;1073
2017-08-01;2017;08;warmińsko-mazurskie;28;78;388;248;365;1079
2017-08-01;2017;08;wielkopolskie;30;202;979;483;870;2534
2017-08-01;2017;08;zachodniopomorskie;32;126;480;276;470;1352
2017-09-01;2017;09;dolnośląskie;02;200;940;436;769;2345
2017-09-01;2017;09;kujawsko-pomorskie;04;116;608;299;533;1556
2017-09-01;2017;09;lubelskie;06;116;670;326;591;1703
2017-09-01;2017;09;lubuskie;08;71;331;161;257;820
2017-09-01;2017;09;łódzkie;10;178;911;413;670;2172
2017-09-01;2017;09;małopolskie;12;153;914;439;754;2260
2017-09-01;2017;09;mazowieckie;14;303;1729;765;1480;4277
2017-09-01;2017;09;opolskie;16;52;301;128;270;751
2017-09-01;2017;09;podkarpackie;18;86;542;265;468;1361
2017-09-01;2017;09;podlaskie;20;52;363;145;340;900
2017-09-01;2017;09;pomorskie;22;137;629;309;550;1625
2017-09-01;2017;09;śląskie;24;329;1470;715;1295;3809
2017-09-01;2017;09;świętokrzyskie;26;73;392;202;332;999
2017-09-01;2017;09;warmińsko-mazurskie;28;97;445;222;345;1109
2017-09-01;2017;09;wielkopolskie;30;195;1003;482;817;2497
2017-09-01;2017;09;zachodniopomorskie;32;103;478;241;481;1303
2017-10-01;2017;10;dolnośląskie;02;181;1076;483;853;2593
2017-10-01;2017;10;kujawsko-pomorskie;04;131;699;318;539;1687
2017-10-01;2017;10;lubelskie;06;116;794;338;660;1908
2017-10-01;2017;10;lubuskie;08;79;332;182;309;902
2017-10-01;2017;10;łódzkie;10;215;1082;471;861;2629
2017-10-01;2017;10;małopolskie;12;180;1069;419;920;2588
2017-10-01;2017;10;mazowieckie;14;336;2066;885;1612;4899
2017-10-01;2017;10;opolskie;16;59;353;158;289;859
2017-10-01;2017;10;podkarpackie;18;91;698;291;569;1649
2017-10-01;2017;10;podlaskie;20;70;417;169;379;1035
2017-10-01;2017;10;pomorskie;22;132;729;337;671;1869
2017-10-01;2017;10;śląskie;24;340;1773;737;1326;4176
2017-10-01;2017;10;świętokrzyskie;26;56;467;217;435;1175
2017-10-01;2017;10;warmińsko-mazurskie;28;105;450;261;411;1227
2017-10-01;2017;10;wielkopolskie;30;188;1088;522;914;2712
2017-10-01;2017;10;zachodniopomorskie;32;107;546;272;487;1412
2017-11-01;2017;11;dolnośląskie;02;179;942;432;804;2357
2017-11-01;2017;11;kujawsko-pomorskie;04;132;635;271;548;1586
2017-11-01;2017;11;lubelskie;06;101;723;334;596;1754
2017-11-01;2017;11;lubuskie;08;69;315;144;258;786
2017-11-01;2017;11;łódzkie;10;160;916;410;757;2243
2017-11-01;2017;11;małopolskie;12;147;1014;373;795;2329
2017-11-01;2017;11;mazowieckie;14;294;1788;736;1449;4267
2017-11-01;2017;11;opolskie;16;45;330;118;299;792
2017-11-01;2017;11;podkarpackie;18;99;554;258;479;1390
2017-11-01;2017;11;podlaskie;20;66;364;177;301;908
2017-11-01;2017;11;pomorskie;22;156;648;295;560;1659
2017-11-01;2017;11;śląskie;24;315;1497;722;1396;3930
2017-11-01;2017;11;świętokrzyskie;26;62;418;202;341;1023
2017-11-01;2017;11;warmińsko-mazurskie;28;88;395;232;334;1049
2017-11-01;2017;11;wielkopolskie;30;181;957;480;827;2445
2017-11-01;2017;11;zachodniopomorskie;32;112;529;243;481;1365
2017-12-01;2017;12;dolnośląskie;02;197;1019;449;819;2484
2017-12-01;2017;12;kujawsko-pomorskie;04;160;626;317;602;1705
2017-12-01;2017;12;lubelskie;06;108;772;312;561;1753
2017-12-01;2017;12;lubuskie;08;61;321;175;272;829
2017-12-01;2017;12;łódzkie;10;167;923;425;793;2308
2017-12-01;2017;12;małopolskie;12;149;1029;393;896;2467
2017-12-01;2017;12;mazowieckie;14;328;1867;787;1550;4532
2017-12-01;2017;12;opolskie;16;66;340;162;295;863
2017-12-01;2017;12;podkarpackie;18;79;639;247;529;1494
2017-12-01;2017;12;podlaskie;20;60;370;176;329;935
2017-12-01;2017;12;pomorskie;22;134;704;329;616;1783
2017-12-01;2017;12;śląskie;24;319;1576;716;1382;3993
2017-12-01;2017;12;świętokrzyskie;26;73;450;210;406;1139
2017-12-01;2017;12;warmińsko-mazurskie;28;89;441;231;351;1112
2017-12-01;2017;12;wielkopolskie;30;207;1076;507;924;2714
2017-12-01;2017;12;zachodniopomorskie;32;122;566;296;520;1504
2018-01-01;2018;01;dolnośląskie;02;199;1072;491;820;2582
2018-01-01;2018;01;kujawsko-pomorskie;04;154;728;301;715;1898
2018-01-01;2018;01;lubelskie;06;115;963;334;740;2152
2018-01-01;2018;01;lubuskie;08;74;334;170;301;879
2018-01-01;2018;01;łódzkie;10;157;997;431;756;2341
2018-01-01;2018;01;małopolskie;12;147;1072;386;887;2492
2018-01-01;2018;01;mazowieckie;14;316;2042;805;1679;4842
2018-01-01;2018;01;opolskie;16;67;372;141;305;885
2018-01-01;2018;01;podkarpackie;18;73;640;241;540;1494
2018-01-01;2018;01;podlaskie;20;63;458;174;400;1095
2018-01-01;2018;01;pomorskie;22;135;803;288;668;1894
2018-01-01;2018;01;śląskie;24;324;1604;706;1363;3997
2018-01-01;2018;01;świętokrzyskie;26;61;475;183;398;1117
2018-01-01;2018;01;warmińsko-mazurskie;28;84;427;211;366;1088
2018-01-01;2018;01;wielkopolskie;30;212;1155;472;910;2749
2018-01-01;2018;01;zachodniopomorskie;32;121;543;250;488;1402
2018-02-01;2018;02;dolnośląskie;02;182;998;461;841;2482
2018-02-01;2018;02;kujawsko-pomorskie;04;124;801;300;646;1871
2018-02-01;2018;02;lubelskie;06;104;847;300;732;1983
2018-02-01;2018;02;lubuskie;08;73;399;156;283;911
2018-02-01;2018;02;łódzkie;10;190;1053;436;860;2539
2018-02-01;2018;02;małopolskie;12;178;1287;398;969;2832
2018-02-01;2018;02;mazowieckie;14;314;2080;704;1561;4659
2018-02-01;2018;02;opolskie;16;58;413;131;284;886
2018-02-01;2018;02;podkarpackie;18;81;657;238;527;1503
2018-02-01;2018;02;podlaskie;20;63;485;170;427;1145
2018-02-01;2018;02;pomorskie;22;131;694;282;639;1746
2018-02-01;2018;02;śląskie;24;333;1761;695;1523;4312
2018-02-01;2018;02;świętokrzyskie;26;70;537;165;439;1211
2018-02-01;2018;02;warmińsko-mazurskie;28;93;464;216;426;1199
2018-02-01;2018;02;wielkopolskie;30;215;1175;477;1026;2893
2018-02-01;2018;02;zachodniopomorskie;32;116;584;225;486;1411
2018-03-01;2018;03;dolnośląskie;02;222;1218;442;988;2870
2018-03-01;2018;03;kujawsko-pomorskie;04;161;880;289;630;1960
2018-03-01;2018;03;lubelskie;06;118;763;286;621;1788
2018-03-01;2018;03;lubuskie;08;86;446;171;327;1030
2018-03-01;2018;03;łódzkie;10;198;1185;458;918;2759
2018-03-01;2018;03;małopolskie;12;157;1100;412;927;2596
2018-03-01;2018;03;mazowieckie;14;318;2190;779;1647;4934
2018-03-01;2018;03;opolskie;16;56;407;140;336;939
2018-03-01;2018;03;podkarpackie;18;88;655;228;546;1517
2018-03-01;2018;03;podlaskie;20;53;484;155;401;1093
2018-03-01;2018;03;pomorskie;22;147;835;291;681;1954
2018-03-01;2018;03;śląskie;24;326;1866;728;1555;4475
2018-03-01;2018;03;świętokrzyskie;26;67;544;220;447;1278
2018-03-01;2018;03;warmińsko-mazurskie;28;92;541;201;441;1275
2018-03-01;2018;03;wielkopolskie;30;243;1301;481;1026;3051
2018-03-01;2018;03;zachodniopomorskie;32;115;724;292;550;1681
2018-04-01;2018;04;dolnośląskie;02;191;988;397;792;2368
2018-04-01;2018;04;kujawsko-pomorskie;04;111;748;318;558;1735
2018-04-01;2018;04;lubelskie;06;127;694;299;607;1727
2018-04-01;2018;04;lubuskie;08;56;345;139;263;803
2018-04-01;2018;04;łódzkie;10;183;1010;395;744;2332
2018-04-01;2018;04;małopolskie;12;174;945;379;806;2304
2018-04-01;2018;04;mazowieckie;14;310;1860;711;1536;4417
2018-04-01;2018;04;opolskie;16;45;342;114;269;770
2018-04-01;2018;04;podkarpackie;18;82;599;234;542;1457
2018-04-01;2018;04;podlaskie;20;52;388;178;372;990
2018-04-01;2018;04;pomorskie;22;128;674;310;548;1660
2018-04-01;2018;04;śląskie;24;325;1521;685;1342;3873
2018-04-01;2018;04;świętokrzyskie;26;68;434;180;405;1087
2018-04-01;2018;04;warmińsko-mazurskie;28;62;475;244;397;1178
2018-04-01;2018;04;wielkopolskie;30;176;993;380;878;2427
2018-04-01;2018;04;zachodniopomorskie;32;110;611;232;454;1407
2018-05-01;2018;05;dolnośląskie;02;215;1064;457;871;2607
2018-05-01;2018;05;kujawsko-pomorskie;04;140;670;303;557;1670
2018-05-01;2018;05;lubelskie;06;108;713;354;678;1853
2018-05-01;2018;05;lubuskie;08;69;334;183;250;836
2018-05-01;2018;05;łódzkie;10;194;1029;432;783;2438
2018-05-01;2018;05;małopolskie;12;172;1054;443;917;2586
2018-05-01;2018;05;mazowieckie;14;271;1952;800;1633;4656
2018-05-01;2018;05;opolskie;16;50;334;132;313;829
2018-05-01;2018;05;podkarpackie;18;89;644;256;523;1512
2018-05-01;2018;05;podlaskie;20;60;412;171;356;999
2018-05-01;2018;05;pomorskie;22;115;698;324;607;1744
2018-05-01;2018;05;śląskie;24;336;1642;700;1347;4025
2018-05-01;2018;05;świętokrzyskie;26;83;453;174;422;1132
2018-05-01;2018;05;warmińsko-mazurskie;28;88;485;222;409;1204
2018-05-01;2018;05;wielkopolskie;30;214;1186;493;962;2855
2018-05-01;2018;05;zachodniopomorskie;32;119;575;233;483;1410
2018-06-01;2018;06;dolnośląskie;02;194;971;414;834;2413
2018-06-01;2018;06;kujawsko-pomorskie;04;138;648;283;540;1609
2018-06-01;2018;06;lubelskie;06;102;673;311;628;1714
2018-06-01;2018;06;lubuskie;08;66;305;160;268;799
2018-06-01;2018;06;łódzkie;10;179;944;420;771;2314
2018-06-01;2018;06;małopolskie;12;177;1066;434;906;2583
2018-06-01;2018;06;mazowieckie;14;295;1793;774;1481;4343
2018-06-01;2018;06;opolskie;16;57;307;141;262;767
2018-06-01;2018;06;podkarpackie;18;101;594;231;546;1472
2018-06-01;2018;06;podlaskie;20;55;371;146;321;893
2018-06-01;2018;06;pomorskie;22;133;730;284;566;1713
2018-06-01;2018;06;śląskie;24;310;1531;709;1318;3868
2018-06-01;2018;06;świętokrzyskie;26;68;454;187;384;1093
2018-06-01;2018;06;warmińsko-mazurskie;28;73;431;233;336;1073
2018-06-01;2018;06;wielkopolskie;30;208;1040;444;908;2600
2018-06-01;2018;06;zachodniopomorskie;32;132;501;267;474;1374
2018-07-01;2018;07;dolnośląskie;02;208;1049;498;881;2636
2018-07-01;2018;07;kujawsko-pomorskie;04;136;695;323;612;1766
2018-07-01;2018;07;lubelskie;06;127;794;294;596;1811
2018-07-01;2018;07;lubuskie;08;62;310;157;296;825
2018-07-01;2018;07;łódzkie;10;181;960;444;832;2417
2018-07-01;2018;07;małopolskie;12;177;1055;419;949;2600
2018-07-01;2018;07;mazowieckie;14;333;2016;832;1537;4718
2018-07-01;2018;07;opolskie;16;62;335;144;289;830
2018-07-01;2018;07;podkarpackie;18;88;644;252;549;1533
2018-07-01;2018;07;podlaskie;20;60;414;167;339;980
2018-07-01;2018;07;pomorskie;22;133;699;344;666;1842
2018-07-01;2018;07;śląskie;24;333;1672;755;1414;4174
2018-07-01;2018;07;świętokrzyskie;26;62;450;217;392;1121
2018-07-01;2018;07;warmińsko-mazurskie;28;82;449;244;418;1193
2018-07-01;2018;07;wielkopolskie;30;212;1111;446;923;2692
2018-07-01;2018;07;zachodniopomorskie;32;118;550;302;535;1505
2018-08-01;2018;08;dolnośląskie;02;196;1059;515;785;2555
2018-08-01;2018;08;kujawsko-pomorskie;04;146;704;335;619;1804
2018-08-01;2018;08;lubelskie;06;111;720;364;613;1808
2018-08-01;2018;08;lubuskie;08;65;299;172;273;809
2018-08-01;2018;08;łódzkie;10;185;1047;429;797;2458
2018-08-01;2018;08;małopolskie;12;159;1018;430;851;2458
2018-08-01;2018;08;mazowieckie;14;305;1821;787;1538;4451
2018-08-01;2018;08;opolskie;16;57;355;121;321;854
2018-08-01;2018;08;podkarpackie;18;86;577;270;512;1445
2018-08-01;2018;08;podlaskie;20;60;368;179;328;935
2018-08-01;2018;08;pomorskie;22;142;711;297;615;1765
2018-08-01;2018;08;śląskie;24;338;1567;677;1313;3895
2018-08-01;2018;08;świętokrzyskie;26;79;446;198;390;1113
2018-08-01;2018;08;warmińsko-mazurskie;28;88;477;261;375;1201
2018-08-01;2018;08;wielkopolskie;30;215;1085;509;951;2760
2018-08-01;2018;08;zachodniopomorskie;32;118;565;276;479;1438
2018-09-01;2018;09;dolnośląskie;02;195;980;455;782;2412
2018-09-01;2018;09;kujawsko-pomorskie;04;132;677;309;577;1695
2018-09-01;2018;09;lubelskie;06;105;725;286;625;1741
2018-09-01;2018;09;lubuskie;08;78;309;188;294;869
2018-09-01;2018;09;łódzkie;10;179;993;439;764;2375
2018-09-01;2018;09;małopolskie;12;168;1060;407;893;2528
2018-09-01;2018;09;mazowieckie;14;341;1855;745;1516;4457
2018-09-01;2018;09;opolskie;16;52;346;124;253;775
2018-09-01;2018;09;podkarpackie;18;88;613;255;490;1446
2018-09-01;2018;09;podlaskie;20;61;380;152;336;929
2018-09-01;2018;09;pomorskie;22;147;683;311;590;1731
2018-09-01;2018;09;śląskie;24;330;1577;746;1412;4065
2018-09-01;2018;09;świętokrzyskie;26;87;450;175;383;1095
2018-09-01;2018;09;warmińsko-mazurskie;28;71;397;230;370;1068
2018-09-01;2018;09;wielkopolskie;30;195;1052;445;931;2623
2018-09-01;2018;09;zachodniopomorskie;32;117;560;254;484;1415
2018-10-01;2018;10;dolnośląskie;02;218;1123;515;854;2710
2018-10-01;2018;10;kujawsko-pomorskie;04;132;696;305;629;1762
2018-10-01;2018;10;lubelskie;06;112;799;359;647;1917
2018-10-01;2018;10;lubuskie;08;76;350;162;321;909
2018-10-01;2018;10;łódzkie;10;203;1083;436;791;2513
2018-10-01;2018;10;małopolskie;12;150;1105;408;1013;2676
2018-10-01;2018;10;mazowieckie;14;344;2102;827;1700;4973
2018-10-01;2018;10;opolskie;16;53;349;143;335;880
2018-10-01;2018;10;podkarpackie;18;90;699;262;639;1690
2018-10-01;2018;10;podlaskie;20;74;424;175;380;1053
2018-10-01;2018;10;pomorskie;22;154;732;339;656;1881
2018-10-01;2018;10;śląskie;24;392;1735;742;1530;4399
2018-10-01;2018;10;świętokrzyskie;26;74;476;223;431;1204
2018-10-01;2018;10;warmińsko-mazurskie;28;107;456;238;402;1203
2018-10-01;2018;10;wielkopolskie;30;225;1162;530;991;2908
2018-10-01;2018;10;zachodniopomorskie;32;105;601;252;524;1482
2018-11-01;2018;11;dolnośląskie;02;196;1055;464;880;2595
2018-11-01;2018;11;kujawsko-pomorskie;04;132;727;308;634;1801
2018-11-01;2018;11;lubelskie;06;98;808;325;664;1895
2018-11-01;2018;11;lubuskie;08;84;334;162;277;857
2018-11-01;2018;11;łódzkie;10;169;1042;414;854;2479
2018-11-01;2018;11;małopolskie;12;158;1114;423;881;2576
2018-11-01;2018;11;mazowieckie;14;311;1945;799;1672;4727
2018-11-01;2018;11;opolskie;16;62;376;147;305;890
2018-11-01;2018;11;podkarpackie;18;90;673;249;602;1614
2018-11-01;2018;11;podlaskie;20;72;402;189;351;1014
2018-11-01;2018;11;pomorskie;22;143;680;319;619;1761
2018-11-01;2018;11;śląskie;24;351;1629;739;1488;4207
2018-11-01;2018;11;świętokrzyskie;26;80;441;218;427;1166
2018-11-01;2018;11;warmińsko-mazurskie;28;77;412;212;364;1065
2018-11-01;2018;11;wielkopolskie;30;219;1138;469;953;2779
2018-11-01;2018;11;zachodniopomorskie;32;135;552;259;501;1447
2018-12-01;2018;12;dolnośląskie;02;227;1163;508;986;2884
2018-12-01;2018;12;kujawsko-pomorskie;04;160;761;338;626;1885
2018-12-01;2018;12;lubelskie;06;109;860;363;698;2030
2018-12-01;2018;12;lubuskie;08;76;410;179;311;976
2018-12-01;2018;12;łódzkie;10;184;1112;460;865;2621
2018-12-01;2018;12;małopolskie;12;174;1237;454;1072;2937
2018-12-01;2018;12;mazowieckie;14;371;2306;866;1826;5369
2018-12-01;2018;12;opolskie;16;60;372;142;290;864
2018-12-01;2018;12;podkarpackie;18;108;755;254;640;1757
2018-12-01;2018;12;podlaskie;20;64;422;199;399;1084
2018-12-01;2018;12;pomorskie;22;148;817;302;701;1968
2018-12-01;2018;12;śląskie;24;343;1879;759;1490;4471
2018-12-01;2018;12;świętokrzyskie;26;73;581;213;490;1357
2018-12-01;2018;12;warmińsko-mazurskie;28;83;505;255;444;1287
2018-12-01;2018;12;wielkopolskie;30;251;1248;526;1105;3130
2018-12-01;2018;12;zachodniopomorskie;32;131;657;306;535;1629
2019-01-01;2019;01;dolnośląskie;02;228;1239;534;1000;3001
2019-01-01;2019;01;kujawsko-pomorskie;04;167;816;334;711;2028
2019-01-01;2019;01;lubelskie;06;125;941;321;774;2161
2019-01-01;2019;01;lubuskie;08;71;377;170;356;974
2019-01-01;2019;01;łódzkie;10;211;1236;469;995;2911
2019-01-01;2019;01;małopolskie;12;210;1415;485;1206;3316
2019-01-01;2019;01;mazowieckie;14;376;2311;924;1938;5549
2019-01-01;2019;01;opolskie;16;64;460;148;389;1061
2019-01-01;2019;01;podkarpackie;18;126;831;330;750;2037
2019-01-01;2019;01;podlaskie;20;74;512;192;416;1194
2019-01-01;2019;01;pomorskie;22;172;903;322;729;2126
2019-01-01;2019;01;śląskie;24;396;2067;891;1686;5040
2019-01-01;2019;01;świętokrzyskie;26;74;572;211;485;1342
2019-01-01;2019;01;warmińsko-mazurskie;28;94;554;245;464;1357
2019-01-01;2019;01;wielkopolskie;30;230;1323;594;1106;3253
2019-01-01;2019;01;zachodniopomorskie;32;101;648;261;551;1561
2019-02-01;2019;02;dolnośląskie;02;236;1273;491;970;2970
2019-02-01;2019;02;kujawsko-pomorskie;04;132;787;342;657;1918
2019-02-01;2019;02;lubelskie;06;132;877;304;719;2032
2019-02-01;2019;02;lubuskie;08;58;425;160;357;1000
2019-02-01;2019;02;łódzkie;10;172;1227;400;909;2708
2019-02-01;2019;02;małopolskie;12;177;1334;420;1052;2983
2019-02-01;2019;02;mazowieckie;14;330;2182;759;1717;4988
2019-02-01;2019;02;opolskie;16;49;455;149;334;987
2019-02-01;2019;02;podkarpackie;18;87;771;267;643;1768
2019-02-01;2019;02;podlaskie;20;50;493;169;407;1119
2019-02-01;2019;02;pomorskie;22;145;823;324;734;2026
2019-02-01;2019;02;śląskie;24;381;1891;819;1603;4694
2019-02-01;2019;02;świętokrzyskie;26;74;568;227;436;1305
2019-02-01;2019;02;warmińsko-mazurskie;28;105;499;246;397;1247
2019-02-01;2019;02;wielkopolskie;30;201;1231;458;1081;2971
2019-02-01;2019;02;zachodniopomorskie;32;115;651;284;527;1577
2019-03-01;2019;03;dolnośląskie;02;199;1194;489;1000;2882
2019-03-01;2019;03;kujawsko-pomorskie;04;140;845;303;689;1977
2019-03-01;2019;03;lubelskie;06;120;834;331;675;1960
2019-03-01;2019;03;lubuskie;08;71;375;170;302;918
2019-03-01;2019;03;łódzkie;10;174;1092;452;880;2598
2019-03-01;2019;03;małopolskie;12;162;1243;449;1024;2878
2019-03-01;2019;03;mazowieckie;14;366;2224;838;1826;5254
2019-03-01;2019;03;opolskie;16;64;406;142;309;921
2019-03-01;2019;03;podkarpackie;18;92;775;267;633;1767
2019-03-01;2019;03;podlaskie;20;66;434;184;365;1049
2019-03-01;2019;03;pomorskie;22;135;792;327;705;1959
2019-03-01;2019;03;śląskie;24;348;1925;682;1541;4496
2019-03-01;2019;03;świętokrzyskie;26;77;521;226;450;1274
2019-03-01;2019;03;warmińsko-mazurskie;28;111;497;237;455;1300
2019-03-01;2019;03;wielkopolskie;30;234;1290;514;1034;3072
2019-03-01;2019;03;zachodniopomorskie;32;129;710;278;570;1687
2019-04-01;2019;04;dolnośląskie;02;189;1080;436;930;2635
2019-04-01;2019;04;kujawsko-pomorskie;04;148;772;291;638;1849
2019-04-01;2019;04;lubelskie;06;101;754;317;650;1822
2019-04-01;2019;04;lubuskie;08;85;328;141;301;855
2019-04-01;2019;04;łódzkie;10;179;1009;463;831;2482
2019-04-01;2019;04;małopolskie;12;158;1181;422;939;2700
2019-04-01;2019;04;mazowieckie;14;319;2196;760;1664;4939
2019-04-01;2019;04;opolskie;16;62;362;141;298;863
2019-04-01;2019;04;podkarpackie;18;90;671;283;585;1629
2019-04-01;2019;04;podlaskie;20;68;434;169;393;1064
2019-04-01;2019;04;pomorskie;22;139;746;321;642;1848
2019-04-01;2019;04;śląskie;24;310;1719;679;1418;4126
2019-04-01;2019;04;świętokrzyskie;26;55;483;181;428;1147
2019-04-01;2019;04;warmińsko-mazurskie;28;92;491;223;379;1185
2019-04-01;2019;04;wielkopolskie;30;215;1120;499;984;2818
2019-04-01;2019;04;zachodniopomorskie;32;127;619;258;531;1535
2019-05-01;2019;05;dolnośląskie;02;185;1066;448;883;2582
2019-05-01;2019;05;kujawsko-pomorskie;04;164;733;311;638;1846
2019-05-01;2019;05;lubelskie;06;99;738;327;682;1846
2019-05-01;2019;05;lubuskie;08;70;337;175;291;873
2019-05-01;2019;05;łódzkie;10;181;983;428;803;2395
2019-05-01;2019;05;małopolskie;12;166;1096;439;897;2598
2019-05-01;2019;05;mazowieckie;14;326;1983;753;1740;4802
2019-05-01;2019;05;opolskie;16;61;330;156;294;841
2019-05-01;2019;05;podkarpackie;18;86;655;264;599;1604
2019-05-01;2019;05;podlaskie;20;65;451;206;351;1073
2019-05-01;2019;05;pomorskie;22;141;781;314;653;1889
2019-05-01;2019;05;śląskie;24;330;1704;696;1490;4220
2019-05-01;2019;05;świętokrzyskie;26;62;498;218;441;1219
2019-05-01;2019;05;warmińsko-mazurskie;28;83;478;257;418;1236
2019-05-01;2019;05;wielkopolskie;30;237;1062;467;916;2682
2019-05-01;2019;05;zachodniopomorskie;32;100;573;256;482;1411
2019-06-01;2019;06;dolnośląskie;02;201;1046;486;847;2580
2019-06-01;2019;06;kujawsko-pomorskie;04;130;698;289;613;1730
2019-06-01;2019;06;lubelskie;06;104;776;309;655;1844
2019-06-01;2019;06;lubuskie;08;75;350;178;295;898
2019-06-01;2019;06;łódzkie;10;162;1077;413;812;2464
2019-06-01;2019;06;małopolskie;12;161;1094;447;992;2694
2019-06-01;2019;06;mazowieckie;14;337;1964;793;1567;4661
2019-06-01;2019;06;opolskie;16;59;349;143;277;828
2019-06-01;2019;06;podkarpackie;18;92;633;245;555;1525
2019-06-01;2019;06;podlaskie;20;52;408;181;397;1038
2019-06-01;2019;06;pomorskie;22;153;693;300;643;1789
2019-06-01;2019;06;śląskie;24;338;1668;719;1478;4203
2019-06-01;2019;06;świętokrzyskie;26;90;490;188;435;1203
2019-06-01;2019;06;warmińsko-mazurskie;28;91;468;258;426;1243
2019-06-01;2019;06;wielkopolskie;30;218;1164;462;919;2763
2019-06-01;2019;06;zachodniopomorskie;32;128;620;253;501;1502
2019-07-01;2019;07;dolnośląskie;02;195;1094;453;835;2577
2019-07-01;2019;07;kujawsko-pomorskie;04;151;701;311;624;1787
2019-07-01;2019;07;lubelskie;06;103;767;314;636;1820
2019-07-01;2019;07;lubuskie;08;92;318;148;325;883
2019-07-01;2019;07;łódzkie;10;152;1107;408;854;2521
2019-07-01;2019;07;małopolskie;12;178;1119;417;918;2632
2019-07-01;2019;07;mazowieckie;14;297;1905;789;1592;4583
2019-07-01;2019;07;opolskie;16;54;354;131;297;836
2019-07-01;2019;07;podkarpackie;18;88;651;248;604;1591
2019-07-01;2019;07;podlaskie;20;72;384;182;359;997
2019-07-01;2019;07;pomorskie;22;145;718;285;670;1818
2019-07-01;2019;07;śląskie;24;310;1695;736;1439;4180
2019-07-01;2019;07;świętokrzyskie;26;72;454;191;398;1115
2019-07-01;2019;07;warmińsko-mazurskie;28;96;465;258;396;1215
2019-07-01;2019;07;wielkopolskie;30;188;1077;474;963;2702
2019-07-01;2019;07;zachodniopomorskie;32;114;579;279;476;1448
2019-08-01;2019;08;dolnośląskie;02;226;1069;421;868;2584
2019-08-01;2019;08;kujawsko-pomorskie;04;164;665;329;555;1713
2019-08-01;2019;08;lubelskie;06;92;737;324;597;1750
2019-08-01;2019;08;lubuskie;08;70;312;186;291;859
2019-08-01;2019;08;łódzkie;10;182;1009;386;788;2365
2019-08-01;2019;08;małopolskie;12;162;1037;397;863;2459
2019-08-01;2019;08;mazowieckie;14;292;1875;803;1479;4449
2019-08-01;2019;08;opolskie;16;43;357;116;302;818
2019-08-01;2019;08;podkarpackie;18;94;654;239;537;1524
2019-08-01;2019;08;podlaskie;20;61;353;178;332;924
2019-08-01;2019;08;pomorskie;22;137;682;323;667;1809
2019-08-01;2019;08;śląskie;24;323;1565;710;1439;4037
2019-08-01;2019;08;świętokrzyskie;26;82;413;192;419;1106
2019-08-01;2019;08;warmińsko-mazurskie;28;92;465;238;406;1201
2019-08-01;2019;08;wielkopolskie;30;196;1113;484;975;2768
2019-08-01;2019;08;zachodniopomorskie;32;118;589;260;524;1491
2019-09-01;2019;09;dolnośląskie;02;168;1004;436;851;2459
2019-09-01;2019;09;kujawsko-pomorskie;04;124;676;280;546;1626
2019-09-01;2019;09;lubelskie;06;117;724;297;594;1732
2019-09-01;2019;09;lubuskie;08;59;356;158;301;874
2019-09-01;2019;09;łódzkie;10;169;976;389;756;2290
2019-09-01;2019;09;małopolskie;12;153;1070;443;904;2570
2019-09-01;2019;09;mazowieckie;14;296;1855;766;1554;4471
2019-09-01;2019;09;opolskie;16;45;355;136;299;835
2019-09-01;2019;09;podkarpackie;18;80;643;248;530;1501
2019-09-01;2019;09;podlaskie;20;47;417;155;355;974
2019-09-01;2019;09;pomorskie;22;123;718;302;638;1781
2019-09-01;2019;09;śląskie;24;338;1604;684;1373;3999
2019-09-01;2019;09;świętokrzyskie;26;63;474;184;394;1115
2019-09-01;2019;09;warmińsko-mazurskie;28;91;441;232;387;1151
2019-09-01;2019;09;wielkopolskie;30;204;1093;450;1020;2767
2019-09-01;2019;09;zachodniopomorskie;32;105;603;265;493;1466
2019-10-01;2019;10;dolnośląskie;02;195;1137;460;911;2703
2019-10-01;2019;10;kujawsko-pomorskie;04;156;720;303;646;1825
2019-10-01;2019;10;lubelskie;06;110;777;309;655;1851
2019-10-01;2019;10;lubuskie;08;71;354;176;347;948
2019-10-01;2019;10;łódzkie;10;185;1060;448;819;2512
2019-10-01;2019;10;małopolskie;12;164;1222;438;1037;2861
2019-10-01;2019;10;mazowieckie;14;342;2090;755;1656;4843
2019-10-01;2019;10;opolskie;16;49;367;124;353;893
2019-10-01;2019;10;podkarpackie;18;96;656;261;558;1571
2019-10-01;2019;10;podlaskie;20;54;405;162;367;988
2019-10-01;2019;10;pomorskie;22;120;787;333;659;1899
2019-10-01;2019;10;śląskie;24;332;1749;648;1540;4269
2019-10-01;2019;10;świętokrzyskie;26;50;541;212;442;1245
2019-10-01;2019;10;warmińsko-mazurskie;28;102;507;234;396;1239
2019-10-01;2019;10;wielkopolskie;30;218;1148;441;1029;2836
2019-10-01;2019;10;zachodniopomorskie;32;132;609;298;554;1593
2019-11-01;2019;11;dolnośląskie;02;192;1056;450;930;2628
2019-11-01;2019;11;kujawsko-pomorskie;04;135;711;314;629;1789
2019-11-01;2019;11;lubelskie;06;122;759;309;670;1860
2019-11-01;2019;11;lubuskie;08;69;342;167;339;917
2019-11-01;2019;11;łódzkie;10;159;982;408;803;2352
2019-11-01;2019;11;małopolskie;12;159;1112;416;917;2604
2019-11-01;2019;11;mazowieckie;14;294;1931;763;1676;4664
2019-11-01;2019;11;opolskie;16;57;367;147;307;878
2019-11-01;2019;11;podkarpackie;18;100;663;282;599;1644
2019-11-01;2019;11;podlaskie;20;61;421;124;354;960
2019-11-01;2019;11;pomorskie;22;131;769;326;633;1859
2019-11-01;2019;11;śląskie;24;318;1748;662;1414;4142
2019-11-01;2019;11;świętokrzyskie;26;68;491;179;396;1134
2019-11-01;2019;11;warmińsko-mazurskie;28;82;448;215;365;1110
2019-11-01;2019;11;wielkopolskie;30;222;1074;438;987;2721
2019-11-01;2019;11;zachodniopomorskie;32;104;597;250;489;1440
2019-12-01;2019;12;dolnośląskie;02;191;1164;489;973;2817
2019-12-01;2019;12;kujawsko-pomorskie;04;135;758;335;653;1881
2019-12-01;2019;12;lubelskie;06;108;867;350;699;2024
2019-12-01;2019;12;lubuskie;08;85;428;213;350;1076
2019-12-01;2019;12;łódzkie;10;191;1113;448;901;2653
2019-12-01;2019;12;małopolskie;12;175;1255;462;1060;2952
2019-12-01;2019;12;mazowieckie;14;364;2240;801;1805;5210
2019-12-01;2019;12;opolskie;16;60;395;143;318;916
2019-12-01;2019;12;podkarpackie;18;87;733;308;617;1745
2019-12-01;2019;12;podlaskie;20;43;422;186;374;1025
2019-12-01;2019;12;pomorskie;22;152;797;311;692;1952
2019-12-01;2019;12;śląskie;24;345;1836;741;1569;4491
2019-12-01;2019;12;świętokrzyskie;26;78;534;213;458;1283
2019-12-01;2019;12;warmińsko-mazurskie;28;111;472;212;419;1214
2019-12-01;2019;12;wielkopolskie;30;210;1255;502;1089;3056
2019-12-01;2019;12;zachodniopomorskie;32;114;669;275;591;1649
2020-01-01;2020;01;dolnośląskie;02;180;1203;495;982;2860
2020-01-01;2020;01;kujawsko-pomorskie;04;132;788;351;704;1975
2020-01-01;2020;01;lubelskie;06;106;860;331;727;2024
2020-01-01;2020;01;lubuskie;08;83;387;178;362;1010
2020-01-01;2020;01;łódzkie;10;188;1133;453;909;2683
2020-01-01;2020;01;małopolskie;12;179;1291;461;1066;2997
2020-01-01;2020;01;mazowieckie;14;307;2227;811;1788;5133
2020-01-01;2020;01;opolskie;16;50;401;148;383;982
2020-01-01;2020;01;podkarpackie;18;93;694;259;657;1703
2020-01-01;2020;01;podlaskie;20;57;485;170;406;1118
2020-01-01;2020;01;pomorskie;22;151;800;323;749;2023
2020-01-01;2020;01;śląskie;24;318;1932;743;1687;4680
2020-01-01;2020;01;świętokrzyskie;26;69;522;192;480;1263
2020-01-01;2020;01;warmińsko-mazurskie;28;87;484;226;447;1244
2020-01-01;2020;01;wielkopolskie;30;220;1297;505;1095;3117
2020-01-01;2020;01;zachodniopomorskie;32;114;645;306;593;1658
2020-02-01;2020;02;dolnośląskie;02;199;1207;391;990;2787
2020-02-01;2020;02;kujawsko-pomorskie;04;142;819;280;609;1850
2020-02-01;2020;02;lubelskie;06;111;822;343;680;1956
2020-02-01;2020;02;lubuskie;08;63;318;162;308;851
2020-02-01;2020;02;łódzkie;10;167;1169;400;908;2644
2020-02-01;2020;02;małopolskie;12;161;1262;413;1043;2879
2020-02-01;2020;02;mazowieckie;14;322;2246;752;1818;5138
2020-02-01;2020;02;opolskie;16;69;390;133;315;907
2020-02-01;2020;02;podkarpackie;18;76;669;248;657;1650
2020-02-01;2020;02;podlaskie;20;61;440;168;410;1079
2020-02-01;2020;02;pomorskie;22;120;834;320;721;1995
2020-02-01;2020;02;śląskie;24;339;1895;724;1644;4602
2020-02-01;2020;02;świętokrzyskie;26;64;539;203;473;1279
2020-02-01;2020;02;warmińsko-mazurskie;28;73;464;207;382;1126
2020-02-01;2020;02;wielkopolskie;30;177;1209;459;1023;2868
2020-02-01;2020;02;zachodniopomorskie;32;111;606;257;571;1545
2020-03-01;2020;03;dolnośląskie;02;184;1150;463;995;2792
2020-03-01;2020;03;kujawsko-pomorskie;04;148;817;312;706;1983
2020-03-01;2020;03;lubelskie;06;108;899;325;768;2100
2020-03-01;2020;03;lubuskie;08;74;346;169;347;936
2020-03-01;2020;03;łódzkie;10;178;1166;450;918;2712
2020-03-01;2020;03;małopolskie;12;168;1242;444;1102;2956
2020-03-01;2020;03;mazowieckie;14;331;2367;813;1833;5344
2020-03-01;2020;03;opolskie;16;68;396;150;324;938
2020-03-01;2020;03;podkarpackie;18;105;726;269;682;1782
2020-03-01;2020;03;podlaskie;20;61;531;162;409;1163
2020-03-01;2020;03;pomorskie;22;144;818;334;743;2039
2020-03-01;2020;03;śląskie;24;382;2002;721;1619;4724
2020-03-01;2020;03;świętokrzyskie;26;92;607;214;504;1417
2020-03-01;2020;03;warmińsko-mazurskie;28;97;538;210;432;1277
2020-03-01;2020;03;wielkopolskie;30;202;1244;441;1108;2995
2020-03-01;2020;03;zachodniopomorskie;32;127;649;271;578;1625
2020-04-01;2020;04;dolnośląskie;02;200;1083;451;1011;2745
2020-04-01;2020;04;kujawsko-pomorskie;04;121;728;292;690;1831
2020-04-01;2020;04;lubelskie;06;115;781;286;669;1851
2020-04-01;2020;04;lubuskie;08;78;379;185;300;942
2020-04-01;2020;04;łódzkie;10;172;1070;431;818;2491
2020-04-01;2020;04;małopolskie;12;156;1151;448;945;2700
2020-04-01;2020;04;mazowieckie;14;303;2160;764;1765;4992
2020-04-01;2020;04;opolskie;16;54;397;134;321;906
2020-04-01;2020;04;podkarpackie;18;98;692;236;596;1622
2020-04-01;2020;04;podlaskie;20;47;411;175;381;1014
2020-04-01;2020;04;pomorskie;22;142;727;299;634;1802
2020-04-01;2020;04;śląskie;24;315;1789;692;1490;4286
2020-04-01;2020;04;świętokrzyskie;26;63;492;179;460;1194
2020-04-01;2020;04;warmińsko-mazurskie;28;82;492;228;400;1202
2020-04-01;2020;04;wielkopolskie;30;218;1186;447;1052;2903
2020-04-01;2020;04;zachodniopomorskie;32;117;582;293;557;1549
2020-05-01;2020;05;dolnośląskie;02;194;1049;444;948;2635
2020-05-01;2020;05;kujawsko-pomorskie;04;120;709;318;625;1772
2020-05-01;2020;05;lubelskie;06;114;765;326;701;1906
2020-05-01;2020;05;lubuskie;08;54;340;164;315;873
2020-05-01;2020;05;łódzkie;10;170;1071;424;852;2517
2020-05-01;2020;05;małopolskie;12;171;1126;459;989;2745
2020-05-01;2020;05;mazowieckie;14;300;2031;780;1650;4761
2020-05-01;2020;05;opolskie;16;54;344;147;338;883
2020-05-01;2020;05;podkarpackie;18;96;659;241;590;1586
2020-05-01;2020;05;podlaskie;20;71;407;176;371;1025
2020-05-01;2020;05;pomorskie;22;104;688;340;697;1829
2020-05-01;2020;05;śląskie;24;346;1702;787;1516;4351
2020-05-01;2020;05;świętokrzyskie;26;80;474;196;441;1191
2020-05-01;2020;05;warmińsko-mazurskie;28;113;461;217;439;1230
2020-05-01;2020;05;wielkopolskie;30;209;1182;474;975;2840
2020-05-01;2020;05;zachodniopomorskie;32;109;554;281;532;1476
2020-06-01;2020;06;dolnośląskie;02;185;1058;389;948;2580
2020-06-01;2020;06;kujawsko-pomorskie;04;124;684;281;631;1720
2020-06-01;2020;06;lubelskie;06;99;783;293;659;1834
2020-06-01;2020;06;lubuskie;08;60;331;146;271;808
2020-06-01;2020;06;łódzkie;10;170;1038;429;848;2485
2020-06-01;2020;06;małopolskie;12;166;1087;414;932;2599
2020-06-01;2020;06;mazowieckie;14;293;1979;737;1654;4663
2020-06-01;2020;06;opolskie;16;53;356;135;318;862
2020-06-01;2020;06;podkarpackie;18;96;686;275;600;1657
2020-06-01;2020;06;podlaskie;20;37;434;149;332;952
2020-06-01;2020;06;pomorskie;22;134;722;311;647;1814
2020-06-01;2020;06;śląskie;24;310;1659;643;1482;4094
2020-06-01;2020;06;świętokrzyskie;26;80;484;205;417;1186
2020-06-01;2020;06;warmińsko-mazurskie;28;80;456;199;379;1114
2020-06-01;2020;06;wielkopolskie;30;213;1117;476;920;2726
2020-06-01;2020;06;zachodniopomorskie;32;94;600;277;498;1469
2020-07-01;2020;07;dolnośląskie;02;189;1015;463;939;2606
2020-07-01;2020;07;kujawsko-pomorskie;04;120;740;291;598;1749
2020-07-01;2020;07;lubelskie;06;114;740;286;621;1761
2020-07-01;2020;07;lubuskie;08;79;372;140;307;898
2020-07-01;2020;07;łódzkie;10;170;1029;439;893;2531
2020-07-01;2020;07;małopolskie;12;188;1176;465;987;2816
2020-07-01;2020;07;mazowieckie;14;320;1947;796;1742;4805
2020-07-01;2020;07;opolskie;16;71;346;138;317;872
2020-07-01;2020;07;podkarpackie;18;96;656;276;584;1612
2020-07-01;2020;07;podlaskie;20;66;394;172;392;1024
2020-07-01;2020;07;pomorskie;22;136;740;322;649;1847
2020-07-01;2020;07;śląskie;24;312;1701;703;1526;4242
2020-07-01;2020;07;świętokrzyskie;26;77;467;184;407;1135
2020-07-01;2020;07;warmińsko-mazurskie;28;100;451;229;436;1216
2020-07-01;2020;07;wielkopolskie;30;197;1089;461;1055;2802
2020-07-01;2020;07;zachodniopomorskie;32;124;586;282;538;1530
2020-08-01;2020;08;dolnośląskie;02;193;1094;423;941;2651
2020-08-01;2020;08;kujawsko-pomorskie;04;129;754;317;649;1849
2020-08-01;2020;08;lubelskie;06;123;837;336;616;1912
2020-08-01;2020;08;lubuskie;08;63;387;164;321;935
2020-08-01;2020;08;łódzkie;10;192;1095;428;877;2592
2020-08-01;2020;08;małopolskie;12;166;1194;430;1026;2816
2020-08-01;2020;08;mazowieckie;14;319;2130;780;1714;4943
2020-08-01;2020;08;opolskie;16;63;393;146;337;939
2020-08-01;2020;08;podkarpackie;18;90;693;279;630;1692
2020-08-01;2020;08;podlaskie;20;56;391;174;337;958
2020-08-01;2020;08;pomorskie;22;138;747;328;678;1891
2020-08-01;2020;08;śląskie;24;342;1816;718;1633;4509
2020-08-01;2020;08;świętokrzyskie;26;71;453;213;433;1170
2020-08-01;2020;08;warmińsko-mazurskie;28;105;459;253;419;1236
2020-08-01;2020;08;wielkopolskie;30;199;1184;521;1046;2950
2020-08-01;2020;08;zachodniopomorskie;32;110;643;274;614;1641
2020-09-01;2020;09;dolnośląskie;02;170;1130;421;945;2666
2020-09-01;2020;09;kujawsko-pomorskie;04;127;758;296;636;1817
2020-09-01;2020;09;lubelskie;06;112;749;321;677;1859
2020-09-01;2020;09;lubuskie;08;77;399;124;306;906
2020-09-01;2020;09;łódzkie;10;170;1104;379;855;2508
2020-09-01;2020;09;małopolskie;12;182;1227;452;942;2803
2020-09-01;2020;09;mazowieckie;14;341;2132;762;1761;4996
2020-09-01;2020;09;opolskie;16;43;364;120;348;875
2020-09-01;2020;09;podkarpackie;18;91;671;242;616;1620
2020-09-01;2020;09;podlaskie;20;60;430;174;373;1037
2020-09-01;2020;09;pomorskie;22;128;761;334;729;1952
2020-09-01;2020;09;śląskie;24;309;1720;702;1559;4290
2020-09-01;2020;09;świętokrzyskie;26;53;492;216;427;1188
2020-09-01;2020;09;warmińsko-mazurskie;28;90;472;215;415;1192
2020-09-01;2020;09;wielkopolskie;30;189;1188;476;1033;2886
2020-09-01;2020;09;zachodniopomorskie;32;123;567;281;530;1501
2020-10-01;2020;10;dolnośląskie;02;234;1467;558;1416;3675
2020-10-01;2020;10;kujawsko-pomorskie;04;151;964;393;928;2436
2020-10-01;2020;10;lubelskie;06;143;1175;388;1032;2738
2020-10-01;2020;10;lubuskie;08;75;515;230;494;1314
2020-10-01;2020;10;łódzkie;10;241;1596;538;1322;3697
2020-10-01;2020;10;małopolskie;12;236;2004;587;1930;4757
2020-10-01;2020;10;mazowieckie;14;358;2908;943;2390;6599
2020-10-01;2020;10;opolskie;16;70;579;179;523;1351
2020-10-01;2020;10;podkarpackie;18;132;1215;379;1186;2912
2020-10-01;2020;10;podlaskie;20;79;616;240;543;1478
2020-10-01;2020;10;pomorskie;22;145;1042;355;994;2536
2020-10-01;2020;10;śląskie;24;394;2557;892;2424;6267
2020-10-01;2020;10;świętokrzyskie;26;117;835;273;782;2007
2020-10-01;2020;10;warmińsko-mazurskie;28;93;610;282;579;1564
2020-10-01;2020;10;wielkopolskie;30;282;1649;584;1500;4015
2020-10-01;2020;10;zachodniopomorskie;32;101;747;329;697;1874
2020-11-01;2020;11;dolnośląskie;02;316;2088;701;1987;5092
2020-11-01;2020;11;kujawsko-pomorskie;04;203;1251;431;1205;3090
2020-11-01;2020;11;lubelskie;06;189;1669;540;1583;3981
2020-11-01;2020;11;lubuskie;08;97;739;260;702;1798
2020-11-01;2020;11;łódzkie;10;280;2029;631;1854;4794
2020-11-01;2020;11;małopolskie;12;246;2402;643;2266;5557
2020-11-01;2020;11;mazowieckie;14;500;3912;1232;3524;9168
2020-11-01;2020;11;opolskie;16;100;711;235;837;1883
2020-11-01;2020;11;podkarpackie;18;161;1473;473;1488;3595
2020-11-01;2020;11;podlaskie;20;86;855;283;801;2025
2020-11-01;2020;11;pomorskie;22;189;1325;425;1363;3302
2020-11-01;2020;11;śląskie;24;455;3053;1066;3158;7732
2020-11-01;2020;11;świętokrzyskie;26;106;991;282;1002;2381
2020-11-01;2020;11;warmińsko-mazurskie;28;128;895;288;799;2110
2020-11-01;2020;11;wielkopolskie;30;343;2122;765;2120;5350
2020-11-01;2020;11;zachodniopomorskie;32;149;1016;359;937;2461
2020-12-01;2020;12;dolnośląskie;02;245;1741;605;1560;4151
2020-12-01;2020;12;kujawsko-pomorskie;04;209;1305;421;1292;3227
2020-12-01;2020;12;lubelskie;06;154;1276;451;1233;3114
2020-12-01;2020;12;lubuskie;08;79;541;222;590;1432
2020-12-01;2020;12;łódzkie;10;259;1682;544;1437;3922
2020-12-01;2020;12;małopolskie;12;200;1532;499;1339;3570
2020-12-01;2020;12;mazowieckie;14;405;3256;1036;2832;7529
2020-12-01;2020;12;opolskie;16;89;621;196;546;1452
2020-12-01;2020;12;podkarpackie;18;130;1065;372;978;2545
2020-12-01;2020;12;podlaskie;20;76;670;256;604;1606
2020-12-01;2020;12;pomorskie;22;160;1182;431;1219;2992
2020-12-01;2020;12;śląskie;24;415;2508;925;2365;6213
2020-12-01;2020;12;świętokrzyskie;26;85;768;291;701;1845
2020-12-01;2020;12;warmińsko-mazurskie;28;108;912;322;833;2175
2020-12-01;2020;12;wielkopolskie;30;294;1837;742;1932;4805
2020-12-01;2020;12;zachodniopomorskie;32;150;1039;391;1031;2611
